7
30;20;14
0:2;0:1;0:3;S:2;0:0;0:0;0:0;
0:1;0:2;0:2;0:0;0:0;0:0;0:0;
0:3;0:2;0:1;0:1;0:1;0:2;0:0;
0:1;0:0;0:0;0:1;0:1;0:1;0:0;
0:2;0:0;0:0;0:2;0:3;0:2;0:2;
0:0;0:2;0:2;0:0;0:0;0:0;0:1;
0:0;E:1;0:2;0:1;0:1;0:1;0:2;