5
25;14;10
S:2;0:0;0:0;0:0;0:0;
0:2;0:1;0:1;0:2;0:0;
0:0;0:0;0:2;0:2;0:0;
0:0;0:0;0:2;0:2;0:0;
0:0;0:0;0:1;E:1;0:5;