5
20;14;10
S:W:2;0:0:0;0:0:0;0:0:0;0:0:0;
0:W:2;0:W:1;0:W:1;0:W:2;0:0:0;
0:0:0;0:0:0;0:W:2;0:W:2;0:0:0;
0:0:0;0:0:0;0:W:2;0:W:2;0:0:0;
0:0:0;0:0:0;0:W:1;E:W:1;0:0:0;