8
60;50;40
0:0:0;S:W:1;S:L:1;0:0:0;0:L:2;0:L:2;0:0:0;0:0:0;
0:W:2;0:W:4;0:L:2;0:L:1;0:L:2;0:L:2;0:L:1;0:L:2;
0:W:1;0:W:1;0:W:2;0:W:1;0:W:2;0:L:0;0:0:0;E:L:2;
0:W:1;0:W:1;0:W:1;0:W:2;0:W:4;0:L:0;0:W:2;0:W:2;
0:W:1;0:W:1;0:W:1;0:W:1;0:W:1;0:W:2;0:W:3;0:W:1;
0:W:1;0:W:1;0:W:1;0:W:1;0:W:1;0:W:1;0:0:0;0:W:1;
0:W:1;0:W:2;0:W:1;0:W:2;0:0:0;0:W:1;0:0:0;0:W:1;
0:W:2;0:W:2;0:W:2;0:W:2;0:W:1;0:W:2;0:0:0;E:W:2;